1111011111111
1EPC110000001
110C111010011
1000000000001
1111111111111
