111111111111
1PE0000001C1
1C0000000111
100000000001
111111111111