111111111111111111111111111111
1C10001000100010001000100010E1
101010101010101010101010101011
101010101010101010101010101011
101010101010101010101010101011
101010101010101010101010101011
101010101010101010101010101011
101010101010101010101010101011
101010101010101010101010101011
101010101010101010101010101011
101010101010101010101010101011
101010101010101010101010101011
101010101010101010101010101011
101010101010101010101010101011
10001000100010P010001000100011
111111111111111111111111111111